                            
                            
                            
++++++++++++++++++++++++++++
+..         .++............+
+.++++.+++++.++.+++++.++++.+
+*+  +.+   +.++.+   +.+  +*+
+.++++.+++++.++.+++++.++++.+
+..                    ....+
+.++++.++.++++++++.++.++++.+
+.++++.++.++++++++.++.++++.+
+......++....++....++......+
++++++.+++++ ++ +++++.++++++
     +.+++++ ++ +++++.+     
     +.++          ++.+     
     +.++ +++--+++ ++.+     
++++++.++ +      + ++.++++++
      .   +      +   .      
++++++.++ +      + ++.++++++
     +.++ ++++++++ ++.+     
     +.++          ++.+     
     +.++ ++++++++ ++.+     
++++++.++ ++++++++ ++.++++++
+...        .++............+
+.++++.+++++.++.+++++.++++.+
+.++++.+++++.++.+++++.++++.+
+*..++         .......++..*+
+++.++.++.++++++++.++.++.+++
+++.++.++.++++++++.++.++.+++
+......++....++....++......+
+.++++++++++.++.++++++++++.+
+.++++++++++.++.++++++++++.+
+..                    ....+
++++++++++++++++++++++++++++
                            
                            
